        @@@
   @@@  @@@
@aa@$@@@@@@@@@
@bb@@@      A@
@           @@
@           @@
@       @@@@@@
@@@@@   @@@
 @@^@   @@@
  @@@   @@@@@B