            @@@
  @@@aa@@@cc@p@
  @@@  C$@  @@@
  @@@  @@@
  @B@  D@E
  @@@  @@@
@@@@   @@@bbF@@
@A          @q@
            @^@
            @@@