     @@A@@@
     @@@@@@c
@@@  A@@A@@@@@
@$@aa@@@@AA@@A
     @@A@@A@@@
     @@@@@@A@@
@@@  @@@@@@A@@@
@^@bb@A@  @@@AB
@@@  @@@   @@@@
@@@         @@@