@@@
@$@@@@@@@e  @@@
@@@    d@@@@@^@
@@@         AB@
@@@
@@@
@@@   b@@@@@D
@@@@@@@@c  @@
@C@        @@
@@@        @E
