           @@@@
 @@@@aa@A@@@@$@
 @@@@       @@@
 @@B@
 @@@@
   @@@C@cc@@@
          @@@@D
@@@       @@@@@
@^@@@dd@@@@@@
@@@@