      @@@@  @@@
@@@@  @@B@  @^@
@@A@  @@@@  @@@
@@@@  @@@@  @@@
@$@@aa@@@@bb@@@
@@@@  @@@@

A: SOFT, TOGGLE a
B: HARD, TOGGLE b
a: OFF
b: OFF