            B
     @@@  @@@
     @A@@@@@a
   @@@@@  @@
   @^@b   @@
 @@@@@   @@@@
@@$@     @@@@
@@@@  @@@@@
     @@@
     @@@