     @@@@@@
     @  @@@
     @  @@@@@
$@@@@@     @@@@
    @@@    @@^@
    @@@     @@@
      @  @@
      @@@@@
      @@@@@
       @@@