     @@    @@@
   @@@@@@  @^@
@@@@@@A@@@@@@@
@$@@A  @@@@@c
@@@      @@@
 @        @
 @        @
 @d      a@
 @@      @@
  C      D