        @@@@
        @@@@
@@@     @  @@@@
@$@@@@@@@   @^@
@@@    @@A  @@@
@@@    @@@  @@@
 @@a   @
  @@@@@@

A: hard, toggle a
a: off