  @@
  @@@
  @@C     @@@e
   @@@@b  @^@e
      @@aa@@@
 @@   @@
@@A@cc@@
@$d   @@   @@@
@@d   @@B@@@@@
           @@@
