          @@@@
   b@@@@@@@C@D
 $cc@A@   @@@@
B@  @@      @
@@  @       @
@@@@@     @@@
@@@  p@qee@^@
     E@a  @@@
