            @A
  @@aa@@   @@@
 @@@dd@@  @B@@
 @^@   @@@@@
 @@@    @@@
         @@
    @@@  @$
@@cc@C@  @@
@@bb@@@@@@@