 @@@a
 @^@a
 @@@
 @   @@@@@@
 @   @@  @@
$@@@@@@  @@@
     @A    @
     @@@@  @
     @@@@@@@
        @@@