     @@@@    A
     @@B@@@  @
    @@@@@@@  @
@@aa@@@@  @@p@
@@@c  @   @@
@@@   @   $
 @    @@@
 C    @^@c
      @@@
