 $@@@@@@@@A@@@@
     @@      @@
     @@      @@
             @@
             @@
@@@  @@bb@B@@@@
@^@  @@
@@@  @@
 @@  @@
 @aa@@@@@@C@@@
