       C
@@A@   @
@@@@@  @
@B$@@@@@cc@@ff@
@@@@@e  @   @
@@A@    @   @
@       F  @@@
@         @@^@
@ffE      @@@@
