 @@@        @@@
 @A@        @E@
 @p@   @@@aa@@@
e@@@f  @^@  @@C
@   @  @@@    @
B   @  !!!    @
@dd@@@!!!!!@@@b
   @$@!!!!!@D@
   @@@!!!!!@@@
   @@@@@c
