   @@@@@!!@@@@
   @^@@     !@
   @@@      !@A
       !@@aa@@@
  $    !!     @
 B@!   !!     @
!!!!   @@c  c@@
!!!@!@!!@!  C@b
@!!!!!!!!!!!@
 !@!!!  !!!!@
