        @@
       @@@
@@  @@@@@@
@$@@@@  @
@@@@    @   @@@
 @@     A@@@@^@
  @     B@  @@@
  @@@b  @@
   @@@  @@
   a@@@@@@
