       @@@  @@@
    @aa@@@bbCp@
@@ff@  @@@  @@@
@@@@@   D
@@
 @     T
 @     @
@@@   @@@  G@@
@$@@@@@@@gg@^@
@@@   @@@  G@@
