@@@!@@@@!@@@@
@@        @@@
@@         @@@
@@@   @@@  @$@
@@@!!!@^@  @@@
@@@  !@@@  @
  @  !!!!!@@
  @@@!!@!!!
   @@!!!!!!
   @@@  @@