      @@@@  @@@
@@@@  @@B@  @^@
@@A@  @@@@  @@@
@@@@  @@@@  @@@
@$@@aa@@@@bb@@@
@@@@  @@@@