@@@    @@@@@@@@
@$@@@@@@@@@  @@
@@@    @@    @@
            @C@
            @@
@@@  !!!!@  AB
@^@!!!!!!!  @@@
@@@!!!!!!!!!@@@
     !!!!!!!@@@
      a@@b
