      @@@@@@@
@@@@  @@@  @@
@@@@@@@@@  @@@@
@$@@       @@^@
@@@@       @@@@
            @@@